20 20
#########**#########
#TKKKKKKK**KKKKKKKG#
#KIIIIIIIIIIIIIIIIK#
#KIIIIIIIIIIIIIIIIK#
#KIIIIIIIIIIIIIIIIK#
#KIIIIIIIIIIIIIIIIK#
**IIIIIIIIIIIIIIIIK#
#KIIIIIIIIIII*IIIIK#
#KIIIIIKIIIIIIIIIIK#
KKIIIIIIIIIIIKIIII**
#KIIIIIIIIIIIIIIIIK#
#KIIIKIIIIIIIIIIII**
#KIIIIIIIIIIIIIIIIK#
#KI*IKIIIIIIIIIIIIK#
#KIIIIIIIIIIIIIIIIK#
#KIIIIIIIIIIIIIIIIK#
KKIIKKKKKKKKKKKKIIKK
#KIIIIIIIIIIIIIIIIK#
#KKKKKKKKKKKKKKKKKK#
########*W##########