20 20
####################
#IIIII###KTK##*****#
#I###-###K#*##*###*#
#IKK#KKKKK#K***#***#
###K#-##*###*#*#*###
#G--KK#*KKKKK-I****#
#-###K**######*###*#
#---#-#**###***#***#
###-#K*-****#*##*###
##I--K#I#*KKKKKK**##
#II##K#I#S#*#*#I#**#
#I###K#I******#I##*#
#III#-#I##*#*##T#**#
###-#K#I#*##**#I#*##
###-#-#----##*#I#**#
###--K####**#**-*#*#
#III#K#**-#**#*#***#
#I###-###-#*##*###*#
#IG*-****-#*-%III**#
####################
