20 20
DDDDDDDDDDDDDDDDDDDD
D*****D******D*****D
D*DDD*D*DDDD*D*DDD*D
D*DDG*D*D**D*D*DDD*D
D*****D******D*****D
D*D*DDD**D*G*DDD*D*D
D*D***DD*DDD*DDD*D*D
D*DDD********DDDDD*D
D*******D*DD*******D
DDDDDDD*D*DT*DDDDDDD
D*******DS*D*******D
D**DD*DDDD**DD*DD**D
DDD*D****DD****DD*DD
D*******DDDD***%***D
D**D*DD*******D*D**D
DD*D*D*DDDTDD*D*D*DD
D**%***D****D***D**D
D*DDDD*D*DD*D*DDDD*D
D********DD********D
DDDDDDDDDDDDDDDDDDDD